111111111111111111111111111111111111111111
110010010000011100011000010100001001000001
100100000000010011000100000001000110010011
101001010000001000011000000011100000000001
100000000000000000000100000001000000000101
110110100000001000100010100010000011000011
1010E0010001000101011000000000000000000001
10000100X001100010000101000100110100100011
110011P00010101000000010111000010000100001
1000001101100001010110011C0100101001010001
110001001001000001000000100110000000001101
110001100000000100011000100100100000000001
1011110101010010000000000C0101010011001111
1110C1010011010100110001000110100000100001
100000001101001001001011101010000100011101
110001010000001001110001001101000C00010001
110001011101100110111110101010101000000001
101100000001000000000000010001010011100001
100100010010000110001011000010000001000001
1000011111000010110000C0010101001000000001
111C00000100000000000110100000010000100CC1
111111111111111111111111111111111111111111