1111111111111111111111111111111111111111
1000XXXXXXXXXXXXXXXXX0001000000000000001
1000CC00CC000CC000CCCC001P00000E00000001
100C0C0000C0000C00000C001000000000000001
10000C00CC000CC000000C001000000C00000001
10000C0000C0000C0000C0001X00000000000001
10000C00CC000CC00000C0000000000000000001
1111111111111111111111111111111111111111