111111111111111111111111111111
1EX00XXXXX000XXX0XXXX000XXXCC1
10X0CC00CC0XXCCXXCCCX0X0XPXCC1
10XC0C00XXC0XX0C00XCX0X0X0XCC1
1000XC0XCC0XXCC00X0CX0X000X001
1000XC00X0CXXXXC0XCX00XXXXX001
1000XC0XCC000CC00XC00000000001
111111111111111111111111111111