1111111111111111111111111111111111
100C0C0000X00000X00000C00C00000001
1010010100100000101001000000010101
1X10C1001010101000100100C000010101
1P00000E00000000X000X0000000000001
1111111111111111111111111111111111