111111111
100C00001
1P0000E01
111111111