1111111111111
10010000000C1
10000E0000001
1P00000000011
1000111110001
1111111111111