111111111111111111111
10P0000000E01000X0001
1000C01000000000000C1
100000C000101000X0001
100C00X000C0100000001
111111111111111111111